8
i  0  3  4 -1  i  0  2  4  6  i  0  4  6 -1  i -1  6 -1 -1  i  0  6 -1 -1  i  0  6 -1 -1  i  0  6 -1 -1  i  0  6 -1 -1
i  0  2  3  4  i  0  2  4 -1  i  0  6 -1 -1  i  0  2  3 -1  i  0  6 -1 -1  i  0  2 -1 -1  i  0  0  6 -1  i  0  4  6 -1
i  0  2  4 -1  i  0  4 -1 -1  g              i  0  2  4  6  i  0  3 -1 -1  i  0  0 -1 -1  i  0  6 -1 -1  i  0  0 -1 -1
i  1  4 -1 -1  i  0  0  2  4  i  0  3 -1 -1  i -1  1 -1 -1  i  1  5 -1 -1  i  0  4  7 -1  i  0  0  6 -1  i  0  0  4 -1
i  0  0 -1 -1  i  0  2  4 -1  i  0  0 -1 -1  i  1  1 -1 -1  i -1  1 -1 -1  i  0  1  4  7  i  0  1  4  7  i  1  0 -1 -1
i  0  2  4 -1  i  0  0 -1 -1  i  0  1  5 -1  i  0  1 -1 -1  i  0  0  3  5  s  0  2  6 -1  i  0  0 -1 -1  i  0  0  4  6
i  0  0  2 -1  i  0  2  6 -1  i  0  6 -1 -1  i  0  2  6 -1  i  0  2  6 -1  i  0  0  2 -1  i  0  0  6 -1  i  0  0 -1 -1
i  0  0  2 -1  i  0  0  2 -1  i  0  2 -1 -1  i  0  6 -1 -1  i -1  2 -1 -1  i  0  2  6 -1  i  0  0  2  6  i  0  0  6 -1