6 3 2 4 6 2 5
3 5 2 4 4 4 1
3 3 2 3 3 4 2
3 4 1 2 2 5 3
4 4 4 2 3 2 4
2 5 4 2 3 2 5
3 5 2 1 4 4 G